名前	アドレス	都道府県
細田 和久	hosoda_kazuhisa@example.com	大阪府
石沢 景子	ishizawa_keiko@example.com	和歌山県
田所 和香	tadokoro_waka@example.com	千葉県
手塚 だん吉	teduka_dankichi@example.com	鹿児島県
田村 めぐみ	tamura_megumi@example.com	神奈川県
清田 ヒロ	kiyota_hiro@example.com	佐賀県
米田 綾女	yoneda_ayame@example.com	愛媛県
平岡 米蔵	hiraoka_yonezou@example.com	北海道
森山 花	moriyama_hana@example.com	兵庫県
井沢 遥	izawa_haruka@example.com	栃木県
荒川 さやか	arakawa_sayaka@example.com	東京都
相馬 美里	aiba_miri@example.com	群馬県
土橋 雅之	tsuchihashi_masayuki@example.com	京都府
土橋 慶二	tsuchihashi_keiji@example.com	北海道
真鍋 美和子	manabe_miwako@example.com	広島県
平山 聡	hirayama_satoshi@example.com	神奈川県
門脇 美月	kadowaki_miduki@example.com	広島県
小菅 太朗	kosuge_tarou@example.com	愛知県
久保田 理紗	kubota_risa@example.com	宮崎県
西秋 慶太	nishiaki_keita@example.com	東京都
渡部 洋介	watabe_yousuke@example.com	東京都
竹村 亮	takemura_ryou@example.com	愛知県
小松 杏	komatsu_ann@example.com	兵庫県
柴山 真一	shibayama_shinichi@example.com	石川県
宮野 しほり	miyano_shihori@example.com	新潟県
原 妃里	hara_yuri@example.com	鹿児島県
奥寺 きみまろ	okudera_kimimaro@example.com	山形県
杉本 徹	sugimoto_tooru@example.com	北海道
島津 奈央	shimadu_nao@example.com	大阪府
松川 真吾	matsukawa_shingo@example.com	岐阜県
江口 さとみ	eguchi_satomi@example.com	大分県
岩田 ジローラモ	iwata_girolamo@example.com	北海道
益田 小百合	masuda_sayuri@example.com	宮城県
蛍原 佑	hotohara_tasuku@example.com	新潟県
飯島 詩織	iijima_shiori@example.com	東京都
金谷 光臣	kanaya_mitsuomi@example.com	青森県
寺田 豊	terada_yutaka@example.com	茨城県
福士 たまき	fukushi_tamaki@example.com	神奈川県
今泉 はるか	imaizumi_haruka@example.com	埼玉県
余 夏希	yo_natsuki@example.com	埼玉県
松川 美幸	matsukawa_miyuki@example.com	栃木県
青木 まみ	aoki_mami@example.com	北海道
金子 紗季	kaneko_saki@example.com	沖縄県
山瀬 和之	yamase_kazuyuki@example.com	千葉県
有賀 郁恵	ariga_ikue@example.com	福岡県
尾形 照生	ogata_teruo@example.com	兵庫県
篠田 美幸	shinoda_miyuki@example.com	福島県
寺西 誠治	teranishi_seiji@example.com	福岡県
池内 しほり	ikeuchi_shihori@example.com	福岡県
相川 幸子	aikawa_sachiko@example.com	茨城県
栗林 佳乃	kuribayashi_yoshino@example.com	山形県
森岡 礼子	morioka_reiko@example.com	千葉県
沖 祐一	oki_yuuichi@example.com	兵庫県
椎名 知史	shiina_tomofumi@example.com	岩手県
梅田 明慶	umeda_akiyoshi@example.com	長崎県
森岡 精児	morioka_seiji@example.com	神奈川県
長岡 サダヲ	nagaoka_sadawo@example.com	東京都
柴咲 有海	shibasaki_ami@example.com	神奈川県
織田 奈月	oda_natsuki@example.com	茨城県
岩間 はるみ	iwama_harumi@example.com	東京都
柳川 洋介	yanagawa_yousuke@example.com	埼玉県
花岡 桃子	hanaoka_momoko@example.com	福岡県
保坂 光良	hosaka_teruyoshi@example.com	千葉県
高田 芳正	takada_yoshimasa@example.com	兵庫県
ほしの まなみ	hoshino_manami@example.com	兵庫県
五大 朝香	godai_asaka@example.com	福岡県
安部 美幸	abe_miyuki@example.com	鹿児島県
中谷 高史	nakatani_takashi@example.com	岩手県
神木 和久	kamiki_kazuhisa@example.com	東京都
飯田 幸子	iida_sachiko@example.com	京都府
藤原 知世	fujiwara_chise@example.com	千葉県
釈 あき	shaku_aki@example.com	福島県
野村 夏希	nomura_natsuki@example.com	岩手県
飯島 砂羽	iijima_sawa@example.com	三重県
真田 恵子	sanada_keiko@example.com	福岡県
横山 和香	yokoyama_waka@example.com	兵庫県
石丸 愛菜	ishimaru_aina@example.com	愛知県
谷本 隆博	tanimoto_takahiro@example.com	福岡県
今 美優	ima_myuu@example.com	新潟県
一木 勤	ichiki_tsutomu@example.com	兵庫県
美輪 功補	miwa_kousuke@example.com	兵庫県
土居 亮介	doi_ryousuke@example.com	群馬県
奥田 ケンイチ	okuda_kenichi@example.com	大阪府
熊田 広司	kumada_kouji@example.com	徳島県
飯田 進	iida_susumu@example.com	広島県
玉城 将也	tamaki_masaya@example.com	静岡県
曽我 翔太	soga_shouta@example.com	大阪府
高崎 勝久	takasaki_katsuhisa@example.com	宮城県
塩田 瞳	shiota_hitomi@example.com	香川県
熊沢 愛梨	kumasawa_airi@example.com	東京都
中島 涼	nakajima_ryou@example.com	新潟県
山岸 信吾	yamagishi_shingo@example.com	山形県
吉永 聡	yoshinaga_satoshi@example.com	埼玉県
少路 樹里	shouji_juri@example.com	鹿児島県
清水 法子	shimizu_noriko@example.com	岡山県
氏家 千夏	ujiie_chinatsu@example.com	東京都
大泉 そら	ooizumi_sora@example.com	岐阜県
西野 弘也	nishino_hironari@example.com	愛知県
川辺 剛基	kawabe_yoshiki@example.com	静岡県
今田 優	imada_yuu@example.com	広島県
神崎 美優	kanzaki_myuu@example.com	千葉県
田端 浩正	tabata_hiromasa@example.com	岐阜県
渡部 悟志	watabe_satoshi@example.com	茨城県
五十嵐 知世	igarashi_chise@example.com	大分県
国分 寛	kokubunn_hiroshi@example.com	愛知県
森口 六郎	moriguchi_rokurou@example.com	宮城県
福本 豊	fukumoto_yutaka@example.com	秋田県
前野 未華子	maeno_mikako@example.com	埼玉県
那須 慎之介	nasu_shinnosuke@example.com	静岡県
平田 米蔵	hirata_yonezou@example.com	愛知県
井上 茂樹	inoue_shigeki@example.com	沖縄県
有村 洋	arimura_you@example.com	佐賀県
松下 裕次郎	matsushita_yuujirou@example.com	兵庫県
窪塚 美嘉	kuboduka_mika@example.com	東京都
伊沢 友香	izawa_tomoka@example.com	千葉県
須賀 賢二	suga_kenji@example.com	東京都
田原 雅之	tahara_masayuki@example.com	滋賀県
有田 愛	arita_ai@example.com	茨城県
富田 遥	tomita_haruka@example.com	大阪府
増井 美幸	masui_miyuki@example.com	三重県
品川 薫	shinagawa_kaoru@example.com	広島県
大石 ヒロ	ooishi_hiro@example.com	愛知県
奈良 雅之	nara_masayuki@example.com	東京都
野村 真吾	nomura_shingo@example.com	神奈川県
寺本 由宇	teramoto_yuu@example.com	高知県
酒井 結衣	sakai_yui@example.com	神奈川県
早川 未來	hayakawa_mirai@example.com	北海道
正木 俊二	masaki_shunji@example.com	神奈川県
野崎 窈	nozaki_you@example.com	広島県
本田 りえ	honnda_rie@example.com	神奈川県
大橋 一徳	oohashi_ittoku@example.com	福岡県
根本 崇史	nemoto_takashi@example.com	宮城県
大竹 祐基	ootake_yuuki@example.com	北海道
古沢 正義	furusawa_masayoshi@example.com	東京都
布川 完爾	fukawa_kanji@example.com	東京都
小菅 宏	kosuge_hiroshi@example.com	愛知県
本山 きみまろ	honnyama_kimimaro@example.com	神奈川県
白木 結衣	shiraki_yui@example.com	北海道
日高 光臣	hidaka_mitsuomi@example.com	神奈川県
滝口 恵梨香	takiguchi_erika@example.com	岐阜県
臼井 鉄二	usui_tetsuji@example.com	愛知県
菅沼 三省	suganuma_sansei@example.com	愛知県
飯田 隆之介	iida_ryuunosuke@example.com	福岡県
田淵 法嗣	tabuchi_houshi@example.com	千葉県
畠山 剛基	hatayama_yoshiki@example.com	宮城県
中西 由宇	nakanishi_yuu@example.com	京都府
内田 ヒカル	uchida_hikaru@example.com	福岡県
大坪 まなみ	ootsubo_manami@example.com	北海道
野際 友以乃	nogiwa_yuino@example.com	岐阜県
重田 博明	shigeta_hiroaki@example.com	千葉県
葛西 詩織	kasai_shiori@example.com	秋田県
山下 徹	yamashita_tooru@example.com	愛媛県
今泉 紗季	imaizumi_saki@example.com	北海道
小峰 コウ	komine_kou@example.com	埼玉県
荒井 育二	arai_ikuji@example.com	千葉県
永田 惇	nagata_atsushi@example.com	三重県
布川 信吾	fukawa_shingo@example.com	石川県
内村 菜摘	uchimura_natsumi@example.com	福岡県
西尾 真希	nishio_maki@example.com	山梨県
梅津 なぎさ	umedu_nagisa@example.com	神奈川県
都築 ひかり	tsuduki_hikari@example.com	山形県
重松 希	shigematsu_nozomi@example.com	埼玉県
高原 たかお	takahara_takao@example.com	大阪府
永野 美嘉	nagano_mika@example.com	秋田県
内野 隼士	uchino_shunji@example.com	福岡県
福山 愛梨	fukuyama_airi@example.com	宮崎県
岩崎 秀樹	iwasaki_hideki@example.com	広島県
神戸 勝久	koube_katsuhisa@example.com	大阪府
村瀬 公顕	murase_kimiaki@example.com	茨城県
岸本 瞬	kishimoto_shun@example.com	大阪府
妻夫木 美優	tsumabuki_myuu@example.com	埼玉県
宮島 光臣	miyajima_mitsuomi@example.com	京都府
羽田 璃子	hata_riko@example.com	大阪府
安達 涼子	adachi_ryouko@example.com	香川県
峰 千佳子	mine_chikako@example.com	和歌山県
古田 春樹	furuta_haruki@example.com	滋賀県
七瀬 恵子	nanase_keiko@example.com	山口県
八十田 和香	yasoda_waka@example.com	福岡県
池田 りえ	ikeda_rie@example.com	大阪府
美木 晃司	miki_kouji@example.com	埼玉県
島田 敏和	shimada_toshikazu@example.com	群馬県
亀山 彩	kameyama_aya@example.com	島根県
古山 正義	furuyama_masayoshi@example.com	東京都
柏木 克実	kashiwagi_katsumi@example.com	佐賀県
堀 聡	hori_satoshi@example.com	広島県
小口 正義	oguchi_masayoshi@example.com	神奈川県
寺沢 美紀	terasawa_miki@example.com	愛知県
平岡 えみ	hiraoka_emi@example.com	滋賀県
大石 俊介	ooishi_shunsuke@example.com	東京都
下山 サンタマリア	shimoyama_stmaria@example.com	東京都
北条 孝太郎	houjou_koutarou@example.com	長崎県
安達 千佳子	adachi_chikako@example.com	兵庫県
秋山 耕司	akiyama_kouji@example.com	千葉県
井川 啓介	igawa_keisuke@example.com	京都府
皆川 晋也	minakawa_shinya@example.com	埼玉県
梅田 恵子	umeda_keiko@example.com	熊本県
高山 サダヲ	takayama_sadawo@example.com	静岡県
林 法子	hayashi_noriko@example.com	沖縄県
芦屋 まさし	ashiya_masashi@example.com	沖縄県
伊沢 詩織	izawa_shiori@example.com	東京都
勝地 哲平	katsudi_teppei@example.com	富山県
及川 たまき	oikawa_tamaki@example.com	神奈川県
岸 慢太郎	kishi_mantarou@example.com	福岡県
楠 雅彦	kusunoki_masahiko@example.com	神奈川県
古沢 理紗	furusawa_risa@example.com	茨城県
市川 瞳	ichikawa_hitomi@example.com	埼玉県
根本 くるみ	nemoto_kurumi@example.com	東京都
加藤 真帆	katou_maho@example.com	群馬県
照井 理紗	terui_risa@example.com	東京都
仲村 亮	nakamura_ryou@example.com	宮城県
畠山 満	hatayama_mitsuru@example.com	大阪府
北条 明	houjou_akira@example.com	神奈川県
おかやま 京子	okayama_kyouko@example.com	東京都
黒木 明宏	kuroki_akihiro@example.com	静岡県
武藤 三郎	mutou_saburou@example.com	大阪府
川上 聡	kawakami_satoshi@example.com	愛知県
前原 優	maehara_yuu@example.com	茨城県
坂野 芽以	itano_mei@example.com	広島県
小島 和久	kojima_kazuhisa@example.com	滋賀県
上条 そら	kamijou_sora@example.com	広島県
小平 和之	kohira_kazuyuki@example.com	山口県
奥田 瞬	okuda_shun@example.com	北海道
山村 フミヤ	yamamura_fumiya@example.com	福岡県
小松 礼子	komatsu_reiko@example.com	新潟県
永井 晃司	nagai_kouji@example.com	奈良県
荒木 あき	araki_aki@example.com	大阪府
米田 紗季	yoneda_saki@example.com	埼玉県
小谷 直人	kotani_naoto@example.com	栃木県
中島 守	nakajima_mamoru@example.com	群馬県
竹下 洋	takeshita_you@example.com	東京都
秋葉 はじめ	akiba_hajime@example.com	神奈川県
今井 優	imai_yuu@example.com	和歌山県
熊沢 瞳	kumasawa_hitomi@example.com	熊本県
野原 窈	nohara_you@example.com	愛媛県
藤田 美佐	fujita_misa@example.com	静岡県
島袋 美嘉	shimabukuro_mika@example.com	東京都
小池 秀樹	koike_hideki@example.com	愛知県
浜田 裕次郎	hamada_yuujirou@example.com	和歌山県
赤松 沙耶	akamatsu_saya@example.com	福岡県
野際 右京	nogiwa_ukyou@example.com	兵庫県
安座間 愛子	azama_aiko@example.com	福島県
竹中 美佐子	takenaka_misako@example.com	北海道
秦 はるか	hata_haruka@example.com	宮城県
渡部 結子	watabe_yuuko@example.com	群馬県
橋爪 はるみ	hashidume_harumi@example.com	茨城県
石黒 悟志	ishiguro_satoshi@example.com	群馬県
楠 花緑	kusunoki_karoku@example.com	秋田県
手塚 敦	teduka_atsushi@example.com	東京都
中原 美幸	nakahara_miyuki@example.com	広島県
上野 一輝	ueno_kazuki@example.com	神奈川県
池田 崇史	ikeda_takashi@example.com	埼玉県
内海 茂樹	uchimi_shigeki@example.com	滋賀県
植松 昌代	uematsu_masayo@example.com	神奈川県
小池 建	koike_ken@example.com	神奈川県
田淵 ノブヒコ	tabuchi_nobuhiko@example.com	茨城県
橋爪 浩太郎	hashidume_koutarou@example.com	北海道
とよた 優	toyota_yuu@example.com	宮崎県
木村 秀隆	kimura_hidetaka@example.com	東京都
伊崎 一樹	isaki_kazuki@example.com	神奈川県
久保田 耕司	kubota_kouji@example.com	青森県
上野 貴美子	ueno_kimiko@example.com	兵庫県
影山 知史	kageyama_tomofumi@example.com	千葉県
宮川 由樹	miyakawa_yuki@example.com	大阪府
小谷 明日	kotani_meibi@example.com	滋賀県
大和 なつみ	yamato_natsumi@example.com	福岡県
末吉 雅之	suekichi_masayuki@example.com	東京都
本村 窈	honnmura_you@example.com	茨城県
三橋 知世	mihashi_chise@example.com	愛知県
篠崎 真吾	shinozaki_shingo@example.com	埼玉県
五十嵐 雅彦	igarashi_masahiko@example.com	兵庫県
北川 しぼり	kitagawa_shibori@example.com	神奈川県
唐沢 莉沙	karasawa_risa@example.com	愛媛県
青木 小雁	aoki_kogan@example.com	神奈川県
田淵 知世	tabuchi_chise@example.com	熊本県
久野 美希	hisano_miki@example.com	長崎県
相田 禄郎	aida_rokurou@example.com	栃木県
宮本 隆太	miyamoto_ryuuta@example.com	埼玉県
岡本 祐一	okamoto_yuuichi@example.com	愛知県
坂下 優	sakashita_yuu@example.com	沖縄県
河野 誠一	kawano_seiichi@example.com	東京都
浜田 直人	hamada_naoto@example.com	秋田県
長尾 美佐	nagao_misa@example.com	千葉県
花田 華子	hanada_hanako@example.com	大阪府
菊田 祐一	kikuta_yuuichi@example.com	東京都
高木 基祐	takagi_kisuke@example.com	秋田県
山田 貴美子	yamada_kimiko@example.com	福島県
武井 そら	takei_sora@example.com	東京都
矢部 杏	yabe_ann@example.com	福島県
大友 利夫	ootomo_toshio@example.com	三重県
柴山 陽子	shibayama_youko@example.com	東京都
柴咲 一樹	shibasaki_kazuki@example.com	広島県
中塚 瞳	nakaduka_hitomi@example.com	静岡県
秦 莉沙	hata_risa@example.com	鹿児島県
生田 まさし	namata_masashi@example.com	北海道
石本 隆	ishimoto_takashi@example.com	福井県
中西 りえ	nakanishi_rie@example.com	栃木県
野崎 遥	nozaki_haruka@example.com	埼玉県
木村 洋介	kimura_yousuke@example.com	愛知県
堤 真一	tsutsumi_shinichi@example.com	北海道
安座間 美幸	azama_miyuki@example.com	三重県
松下 那奈	matsushita_nana@example.com	大阪府
江藤 満	etou_mitsuru@example.com	愛知県
大滝 長利	ootaki_nagatoshi@example.com	千葉県
加納 那奈	kanou_nana@example.com	大阪府
志村 知史	shimura_tomofumi@example.com	広島県
久米 真悠子	kume_mayuko@example.com	北海道
奥田 恵梨香	okuda_erika@example.com	兵庫県
横山 丈史	yokoyama_takeshi@example.com	北海道
脇田 淳子	wakita_atsuko@example.com	東京都
中里 慢太郎	nakazato_mantarou@example.com	福井県
島袋 ひろみ	shimabukuro_hiromi@example.com	静岡県
深沢 優	fukazawa_yuu@example.com	神奈川県
笠原 信輔	kasahara_shinsuke@example.com	栃木県
片瀬 光臣	katase_mitsuomi@example.com	東京都
田原 礼子	tahara_reiko@example.com	岩手県
若山 光	wakayama_hikaru@example.com	佐賀県
柴田 優	shibata_yuu@example.com	岩手県
渋谷 雅彦	shibuya_masahiko@example.com	静岡県
堀 恵子	hori_keiko@example.com	群馬県
福島 浩介	fukushima_kousuke@example.com	宮城県
秦 美佳	hata_mika@example.com	愛知県
門脇 光良	kadowaki_teruyoshi@example.com	京都府
加瀬 璃子	kase_riko@example.com	岩手県
深沢 未來	fukazawa_mirai@example.com	福岡県
中川 まひる	nakagawa_mahiru@example.com	広島県
西村 咲	nishimura_saki@example.com	愛知県
片山 美和子	katayama_miwako@example.com	山形県
藤本 敏和	fujimoto_toshikazu@example.com	香川県
田崎 恵美	tazaki_megumi@example.com	茨城県
岩本 雅彦	iwamoto_masahiko@example.com	大阪府
山中 隆太	yamanaka_ryuuta@example.com	埼玉県
谷村 竜次	tanimura_ryuuji@example.com	新潟県
吉本 悟志	yoshimoto_satoshi@example.com	和歌山県
三宅 俊二	miyake_shunji@example.com	新潟県
大久保 晃司	ookubo_kouji@example.com	兵庫県
松村 雅功	matsumura_masatoshi@example.com	沖縄県
高見 祐一	takami_yuuichi@example.com	福岡県
二宮 はるか	ninomiya_haruka@example.com	茨城県
藤原 華子	fujiwara_hanako@example.com	北海道
一青 翔太	hitoto_shouta@example.com	大阪府
相田 なつみ	aida_natsumi@example.com	大阪府
川野 景子	kawano_keiko@example.com	愛知県
奥田 秀隆	okuda_hidetaka@example.com	東京都
薬師丸 茜	yakushimaru_akane@example.com	愛知県
阿部 俊二	abe_shunji@example.com	茨城県
藤森 小百合	fujimori_sayuri@example.com	佐賀県
伊東 景子	itou_keiko@example.com	東京都
戸田 英嗣	toda_hidetsugu@example.com	群馬県
上田 はじめ	ueda_hajime@example.com	愛知県
菊池 優	kikuchi_yuu@example.com	愛知県
中谷 綾	nakatani_aya@example.com	大阪府
藤澤 米蔵	fujisawa_yonezou@example.com	滋賀県
おかやま 精児	okayama_seiji@example.com	京都府
坂東 奈々	banntou_nana@example.com	茨城県
宮田 禄郎	miyata_rokurou@example.com	茨城県
広田 早紀	hirota_saki@example.com	静岡県
浅利 正敏	asari_masatoshi@example.com	宮崎県
小室 真一	komuro_shinichi@example.com	兵庫県
石崎 広之	ishizaki_hiroyuki@example.com	滋賀県
今井 真奈美	imai_manami@example.com	鹿児島県
寺尾 ひとり	terao_hitori@example.com	島根県
矢野 研二	yano_kenji@example.com	京都府
星野 陽介	hoshino_yousuke@example.com	大分県
小西 聖陽	konishi_masaaki@example.com	広島県
青野 由美子	aono_yumiko@example.com	神奈川県
菅原 沙知絵	sugawara_sachie@example.com	東京都
中塚 哲平	nakaduka_teppei@example.com	長野県
高田 怜奈	takada_reina@example.com	京都府
高崎 さゆり	takasaki_sayuri@example.com	東京都
中岡 真一	nakaoka_shinichi@example.com	福岡県
徳永 将也	tokunaga_masaya@example.com	千葉県
片瀬 洋介	katase_yousuke@example.com	大阪府
相原 彩	aihara_aya@example.com	埼玉県
柴崎 宏行	shibazaki_hiroyuki@example.com	埼玉県
本山 優	honnyama_yuu@example.com	徳島県
山岸 仁	yamagishi_jin@example.com	東京都
藤森 雅功	fujimori_masatoshi@example.com	東京都
安達 直人	adachi_naoto@example.com	愛知県
吉井 勇一	yoshii_yuuichi@example.com	山梨県
篠原 麻緒	shinohara_mao@example.com	富山県
長岡 沙知絵	nagaoka_sachie@example.com	大阪府
高谷 寿々花	takaya_suzuka@example.com	宮城県
三木 千佳子	miki_chikako@example.com	山形県
向井 恵美	murai_megumi@example.com	徳島県
細野 麻由子	hosono_mayuko@example.com	滋賀県
橋口 寛	hashiguchi_hiroshi@example.com	愛知県
梅村 有海	umemura_ami@example.com	岩手県
細川 幸子	hosokawa_sachiko@example.com	福島県
小谷 はじめ	kotani_hajime@example.com	千葉県
浅野 優一	asano_yuuichi@example.com	栃木県
日下 剛基	hinoshita_yoshiki@example.com	福島県
楠 朝香	kusunoki_asaka@example.com	徳島県
柳家 将也	yanagiya_masaya@example.com	兵庫県
町田 はじめ	machida_hajime@example.com	神奈川県
岩田 知史	iwata_tomofumi@example.com	東京都
田原 浩正	tahara_hiromasa@example.com	東京都
森田 涼子	morita_ryouko@example.com	千葉県
真鍋 法嗣	manabe_houshi@example.com	滋賀県
芳賀 淳	haga_atsushi@example.com	長野県
横井 康文	yokoi_yasufumi@example.com	大阪府
玉井 恵美	tamai_megumi@example.com	愛知県
川西 まひる	kawanishi_mahiru@example.com	愛知県
坂口 正義	sakaguchi_masayoshi@example.com	兵庫県
久保田 薫	kubota_kaoru@example.com	静岡県
井手 樹里	ide_juri@example.com	東京都
芦田 勇	ashida_yuu@example.com	北海道
高橋 碧海	takahashi_ouga@example.com	鹿児島県
湯浅 涼子	yuasa_ryouko@example.com	東京都
石原 陽介	ishihara_yousuke@example.com	鹿児島県
岡村 隆太	okamura_ryuuta@example.com	兵庫県
松井 英嗣	matsui_hidetsugu@example.com	兵庫県
遠藤 あさみ	enndou_asami@example.com	宮城県
堀口 たまき	horiguchi_tamaki@example.com	埼玉県
田中 景子	tanaka_keiko@example.com	愛知県
榎本 結衣	enomoto_yui@example.com	兵庫県
久野 草太	hisano_souta@example.com	群馬県
石倉 勇	ishikura_yuu@example.com	神奈川県
三村 克実	mimura_katsumi@example.com	東京都
岩淵 礼子	iwabuchi_reiko@example.com	愛知県
飛田 ケンイチ	hida_kenichi@example.com	兵庫県
熊田 由宇	kumada_yuu@example.com	千葉県
今井 エリカ	imai_erika@example.com	大阪府
立川 貴美子	tachikawa_kimiko@example.com	和歌山県
諏訪 満	suwa_mitsuru@example.com	岐阜県
野口 恵美	noguchi_megumi@example.com	鹿児島県
飯田 敦	iida_atsushi@example.com	埼玉県
坂口 充則	sakaguchi_mitsunori@example.com	東京都
古川 倫子	furukawa_noriko@example.com	埼玉県
吉田 草太	yoshida_souta@example.com	長野県
岩瀬 寿々花	iwase_suzuka@example.com	福島県
伊崎 満	isaki_mitsuru@example.com	奈良県
須賀 くるみ	suga_kurumi@example.com	高知県
六角 秀隆	rokkaku_hidetaka@example.com	島根県
金児 祐基	kaneko_yuuki@example.com	大阪府
中岡 麗奈	nakaoka_rena@example.com	北海道
窪塚 綾女	kuboduka_ayame@example.com	愛知県
前野 きみまろ	maeno_kimimaro@example.com	北海道
武井 玲那	takei_rena@example.com	神奈川県
山川 早織	yamakawa_saori@example.com	埼玉県
平賀 優	hiraga_yuu@example.com	千葉県
内野 染五郎	uchino_somegorou@example.com	愛知県
本間 優	honma_yuu@example.com	愛知県
山上 菜々美	yamagami_nanami@example.com	秋田県
宮島 メイサ	miyajima_meisa@example.com	大阪府
細井 美帆	hosoi_miho@example.com	東京都
保坂 早紀	hosaka_saki@example.com	佐賀県
手島 耕司	tejima_kouji@example.com	香川県
千田 愛子	sennda_aiko@example.com	宮城県
多部 陽子	tabe_youko@example.com	北海道
滝 禄郎	taki_rokurou@example.com	北海道
福井 薫	fukui_kaoru@example.com	京都府
木村 正敏	kimura_masatoshi@example.com	東京都
大西 寿々花	oonishi_suzuka@example.com	神奈川県
福岡 秀隆	fukuoka_hidetaka@example.com	東京都
富樫 昌代	togashi_masayo@example.com	東京都
秦 まさみ	hata_masami@example.com	長野県
三谷 和久	mitani_kazuhisa@example.com	愛知県
神山 広之	kamiyama_hiroyuki@example.com	北海道
堀 啓介	hori_keisuke@example.com	愛知県
正木 郁恵	masaki_ikue@example.com	京都府
諏訪 ノブヒコ	suwa_nobuhiko@example.com	兵庫県
榊原 和香	sakakibara_waka@example.com	北海道
松崎 明	matsuzaki_akira@example.com	岡山県
曽我 菊生	soga_kikuo@example.com	北海道
武 真悠子	take_mayuko@example.com	愛媛県
岩田 優一	iwata_yuuichi@example.com	群馬県
高田 法嗣	takada_houshi@example.com	北海道
相田 妃里	aida_yuri@example.com	広島県
片桐 景子	katagiri_keiko@example.com	大阪府
村上 恵梨香	murakami_erika@example.com	東京都
岩井 聖陽	iwai_masaaki@example.com	千葉県
小田 京子	oda_kyouko@example.com	奈良県
青木 大五郎	aoki_daigorou@example.com	群馬県
塚原 和香	tsukahara_waka@example.com	東京都
江藤 遥	etou_haruka@example.com	広島県
岩崎 直人	iwasaki_naoto@example.com	北海道
田沢 真帆	tazawa_maho@example.com	長野県
進藤 まさみ	shinndou_masami@example.com	岡山県
浅沼 剛基	asanuma_yoshiki@example.com	東京都
柳田 りえ	yanagida_rie@example.com	青森県
一木 一代	ichiki_kazuyo@example.com	沖縄県
新垣 幸子	aragaki_sachiko@example.com	大阪府
石倉 さやか	ishikura_sayaka@example.com	東京都
はしの 結子	hashino_yuuko@example.com	福岡県
木内 三省	kiuchi_sansei@example.com	愛知県
市田 人志	ichida_hitoshi@example.com	福岡県
山口 はるか	yamaguchi_haruka@example.com	神奈川県
福田 徹平	fukuda_teppei@example.com	埼玉県
寺本 那奈	teramoto_nana@example.com	青森県
三浦 優	miura_yuu@example.com	兵庫県
今西 ちえみ	imanishi_chiemi@example.com	愛知県
羽田 宏行	hada_hiroyuki@example.com	岐阜県
岡山 輝信	okayama_akinobu@example.com	栃木県
大田 優一	oota_yuuichi@example.com	山口県
山上 たまき	yamagami_tamaki@example.com	兵庫県
志村 晃司	shimura_kouji@example.com	鹿児島県
神木 佳乃	kamiki_yoshino@example.com	愛知県
植松 夏空	uematsu_sora@example.com	石川県
大川 広司	ookawa_kouji@example.com	岩手県
今西 淳子	imanishi_atsuko@example.com	岐阜県
香椎 華子	kashii_hanako@example.com	千葉県
森山 基祐	moriyama_kisuke@example.com	沖縄県
西田 博之	nishida_hiroyuki@example.com	神奈川県
満島 咲	mitsushima_saki@example.com	群馬県
松田 麻由子	matsuda_mayuko@example.com	静岡県
川畑 勇介	kawahata_yuusuke@example.com	宮城県
志賀 なつみ	shiga_natsumi@example.com	宮崎県
本間 敦	honnma_atsushi@example.com	茨城県
田村 薫	tamura_kaoru@example.com	福井県
今西 扶樹	imanishi_motoki@example.com	石川県
横田 薫	yokota_kaoru@example.com	山形県
奥寺 兼	okudera_ken@example.com	佐賀県
大和 竜也	yamato_tatsuya@example.com	神奈川県
生田 さとみ	namata_satomi@example.com	長崎県
堀越 みき	horikoshi_miki@example.com	岩手県
深谷 瞬	fukaya_shun@example.com	埼玉県
木内 夏空	kiuchi_sora@example.com	香川県
望月 遥	mochiduki_haruka@example.com	神奈川県
小沼 賢治	konuma_kenji@example.com	埼玉県
中園 貴嶺	nakazono_takane@example.com	大阪府
矢野 博之	yano_hiroyuki@example.com	茨城県
片桐 早織	katagiri_saori@example.com	京都府
和田 由樹	wada_yuki@example.com	広島県
永井 あや子	nagai_ayako@example.com	東京都
成瀬 拓郎	naruse_takurou@example.com	京都府
平良 愛子	hirara_aiko@example.com	新潟県
中 優	naka_yuu@example.com	三重県
大沢 夏空	oosawa_sora@example.com	大阪府
福永 はじめ	fukunaga_hajime@example.com	広島県
椎名 公顕	shiina_kimiaki@example.com	大阪府
武田 勇介	takeda_yuusuke@example.com	東京都
釈 南朋	shaku_nao@example.com	長野県
荻野 慢太郎	ogino_mantarou@example.com	大阪府
田口 莉沙	taguchi_risa@example.com	愛知県
はしの 翔太	hashino_shouta@example.com	茨城県
島崎 フミヤ	shimazaki_fumiya@example.com	静岡県
米山 優一	yoneyama_yuuichi@example.com	長野県
本間 真希	honnma_maki@example.com	愛知県
さだ 千佳子	sada_chikako@example.com	岩手県
大島 秀樹	ooshima_hideki@example.com	宮崎県
西島 克実	nishijima_katsumi@example.com	青森県
宇都宮 はるみ	utsunomiya_harumi@example.com	山形県
浜田 景子	hamada_keiko@example.com	福岡県
中沢 聖陽	nakazawa_masaaki@example.com	神奈川県
福原 精児	fukuhara_seiji@example.com	長崎県
大野 恵子	oono_keiko@example.com	東京都
松原 高史	matsubara_takashi@example.com	福岡県
緒方 瞳	ogata_hitomi@example.com	茨城県
土屋 雅之	tsuchiya_masayuki@example.com	千葉県
塚本 千佳子	tsukamoto_chikako@example.com	北海道
水谷 雅之	mizutani_masayuki@example.com	埼玉県
七瀬 愛菜	nanase_aina@example.com	千葉県
島津 寿々花	shimadu_suzuka@example.com	滋賀県
桜田 まひる	sakurada_mahiru@example.com	岩手県
水野 奈月	mizuno_natsuki@example.com	京都府
前野 賢治	maeno_kenji@example.com	広島県
阪口 ひろ子	sakaguchi_hiroko@example.com	島根県
木田 雅之	kida_masayuki@example.com	神奈川県
中根 耕司	nakane_kouji@example.com	神奈川県
川本 啓介	kawamoto_keisuke@example.com	和歌山県
古谷 京子	furutani_kyouko@example.com	東京都
塩見 功補	shiomi_kousuke@example.com	神奈川県
立石 竜次	tachiishi_ryuuji@example.com	新潟県
杉田 和香	sugita_waka@example.com	宮崎県
西田 奈々	nishida_nana@example.com	茨城県
市原 真一	ichihara_shinichi@example.com	神奈川県
福士 莉緒	fukushi_rio@example.com	福島県
蛍原 豊	hotohara_yutaka@example.com	千葉県
豊原 竜也	toyohara_tatsuya@example.com	秋田県
橘 美月	tachibana_miduki@example.com	兵庫県
相川 有起哉	aikawa_yukiya@example.com	北海道
重田 美智子	shigeta_michiko@example.com	神奈川県
大森 薫	oomori_kaoru@example.com	北海道
内山 奈々	uchiyama_nana@example.com	兵庫県
桑田 裕次郎	kuwata_yuujirou@example.com	兵庫県
大槻 秀隆	ootsuki_hidetaka@example.com	宮崎県
栗林 宏	kuribayashi_hiroshi@example.com	富山県
金谷 えみ	kanaya_emi@example.com	群馬県
飯野 ひとみ	iino_hitomi@example.com	愛知県
山上 沙知絵	yamagami_sachie@example.com	栃木県
結城 路子	yuuki_michiko@example.com	北海道
柳 晴臣	yanagi_haruomi@example.com	兵庫県
水田 那奈	mizuta_nana@example.com	京都府
松村 雅彦	matsumura_masahiko@example.com	大阪府
滝川 さとみ	takigawa_satomi@example.com	静岡県
川中 みあ	kawanaka_mia@example.com	岩手県
梅沢 京子	umezawa_kyouko@example.com	千葉県
柴田 ケンイチ	shibata_kenichi@example.com	岐阜県
正木 窈	masaki_you@example.com	北海道
大野 花	oono_hana@example.com	東京都
杉野 めぐみ	sugino_megumi@example.com	東京都
松山 だん吉	matsuyama_dankichi@example.com	高知県
長浜 了	nagahama_ryou@example.com	福岡県
浜野 華子	hamano_hanako@example.com	沖縄県
伊崎 麗奈	isaki_rena@example.com	北海道
外山 みき	sotoyama_miki@example.com	大阪府
有賀 まひる	ariga_mahiru@example.com	沖縄県
森 勇太	mori_yuuta@example.com	岡山県
藤山 朝香	fujiyama_asaka@example.com	千葉県
小寺 長利	kodera_nagatoshi@example.com	長野県
佐藤 真一	satou_shinichi@example.com	山形県
松下 亮	matsushita_ryou@example.com	山形県
平 奈央	taira_nao@example.com	長野県
田尻 知世	tajiri_chise@example.com	長崎県
清水 精児	shimizu_seiji@example.com	東京都
石丸 玲那	ishimaru_rena@example.com	東京都
西本 めぐみ	nishimoto_megumi@example.com	宮崎県
神山 秀樹	kamiyama_hideki@example.com	山口県
長尾 れいな	nagao_reina@example.com	京都府
吉川 守	kikkawa_mamoru@example.com	宮城県
松浦 染五郎	matsuura_somegorou@example.com	兵庫県
坂野 真希	itano_maki@example.com	栃木県
高柳 みき	takayanagi_miki@example.com	宮城県
篠田 あき	shinoda_aki@example.com	岩手県
福永 妃里	fukunaga_yuri@example.com	広島県
紺野 あおい	konno_aoi@example.com	奈良県
岩本 杏	iwamoto_ann@example.com	大阪府
森山 砂羽	moriyama_sawa@example.com	神奈川県
白木 一代	shiraki_kazuyo@example.com	徳島県
滝口 きみまろ	takiguchi_kimimaro@example.com	北海道
福井 那奈	fukui_nana@example.com	北海道
ユースケ 法子	yusuke_noriko@example.com	神奈川県
内野 たまき	uchino_tamaki@example.com	北海道
大和 三郎	yamato_saburou@example.com	埼玉県
山本 真帆	yamamoto_maho@example.com	兵庫県
向井 光良	murai_teruyoshi@example.com	神奈川県
中井 まみ	nakai_mami@example.com	高知県
三宅 惇	miyake_jun@example.com	群馬県
阪本 美里	sakamoto_miri@example.com	島根県
宇多田 莉緒	utada_rio@example.com	愛知県
紺野 隆博	konnno_takahiro@example.com	広島県
堤 ジョージ	tsutsumi_george@example.com	神奈川県
小林 法嗣	kobayashi_houshi@example.com	兵庫県
石山 未來	ishiyama_mirai@example.com	三重県
西原 惇	nishihara_jun@example.com	沖縄県
湯浅 まなみ	yuasa_manami@example.com	北海道
増井 早紀	masui_saki@example.com	神奈川県
田畑 京子	tabata_kyouko@example.com	福岡県
塩見 弘也	shiomi_hironari@example.com	東京都
綾瀬 薫	ayase_kaoru@example.com	三重県
北条 ひろみ	houjou_hiromi@example.com	兵庫県
水谷 明	mizutani_akira@example.com	宮城県
山城 恵子	yamashiro_keiko@example.com	栃木県
磯部 なぎさ	isobe_nagisa@example.com	東京都
高柳 路子	takayanagi_michiko@example.com	静岡県
伊藤 長利	itou_nagatoshi@example.com	東京都
深田 涼	fukada_ryou@example.com	福岡県
宮脇 竜也	miyawaki_tatsuya@example.com	長野県
村瀬 愛梨	murase_airi@example.com	茨城県
尾形 美嘉	ogata_mika@example.com	埼玉県
土田 美佐	tsuchida_misa@example.com	福島県
丹野 賢二	tannno_kenji@example.com	千葉県
菊池 季衣	kikuchi_toshie@example.com	神奈川県
新垣 みゆき	niigaki_miyuki@example.com	熊本県
津川 有海	tsugawa_ami@example.com	大阪府
吹越 惇	fukikoshi_atsushi@example.com	愛知県
山野 光	yamano_hikaru@example.com	長野県
森 彩華	mori_ayaka@example.com	岐阜県
武 満	take_mitsuru@example.com	茨城県
田川 京子	tagawa_kyouko@example.com	岩手県
相沢 雅彦	aizawa_masahiko@example.com	神奈川県
秋山 沙知絵	akiyama_sachie@example.com	広島県
秋葉 由宇	akiba_yuu@example.com	石川県
市村 さやか	ichimura_sayaka@example.com	高知県
平良 かおり	hirara_kaori@example.com	岡山県
寺井 サンタマリア	terai_stmaria@example.com	岐阜県
大森 右京	oomori_ukyou@example.com	神奈川県
平林 ヒロ	hirabayashi_hiro@example.com	兵庫県
山瀬 知史	yamase_tomofumi@example.com	神奈川県
宇都宮 南朋	utsunomiya_nao@example.com	福岡県
大後 砂羽	oogo_sawa@example.com	埼玉県
森山 友以乃	moriyama_yuino@example.com	愛知県
畑中 新太	hatanaka_arata@example.com	東京都
井村 光洋	imura_mitsuhiro@example.com	大阪府
寺尾 昌代	terao_masayo@example.com	東京都
佐々木 幸平	sasaki_kouhei@example.com	福井県
新井 綾	arai_aya@example.com	大阪府
西川 守	nishikawa_mamoru@example.com	沖縄県
佐川 智花	sagawa_tomoka@example.com	広島県
斎藤 仁	saitou_jin@example.com	兵庫県
福永 一徳	fukunaga_ittoku@example.com	東京都
藤森 建	fujimori_ken@example.com	神奈川県
小高 花緑	kodaka_karoku@example.com	愛媛県
大川 雅彦	ookawa_masahiko@example.com	兵庫県
大村 光	oomura_hikaru@example.com	岡山県
藤木 明日	fujiki_meibi@example.com	東京都
諏訪 一徳	suwa_ittoku@example.com	愛知県
村松 隆	muramatsu_takashi@example.com	兵庫県
ほしの 完爾	hoshino_kanji@example.com	東京都
新村 徹	niimura_tooru@example.com	兵庫県
板倉 しほり	itakura_shihori@example.com	京都府
牧田 めぐみ	makita_megumi@example.com	福岡県
小柳 功補	koyanagi_kousuke@example.com	千葉県
ほしの 窈	hoshino_you@example.com	熊本県
神保 友以乃	jinbo_yuino@example.com	岐阜県
木下 恵梨香	kinoshita_erika@example.com	静岡県
川村 精児	kawamura_seiji@example.com	大阪府
増井 恵梨香	masui_erika@example.com	長崎県
鬼頭 米蔵	kitou_yonezou@example.com	東京都
落合 希	ochiai_nozomi@example.com	神奈川県
七瀬 誠一	nanase_seiichi@example.com	大阪府
三橋 恵美	mihashi_megumi@example.com	岩手県
岩間 エリカ	iwama_erika@example.com	東京都
山内 良介	yamauchi_ryousuke@example.com	千葉県
秋本 米蔵	akimoto_yonezou@example.com	京都府
平林 くるみ	hirabayashi_kurumi@example.com	福岡県
岩下 美帆	iwashita_miho@example.com	兵庫県
松永 恵子	matsunaga_keiko@example.com	岩手県
田尻 将也	tajiri_masaya@example.com	千葉県
今泉 小百合	imaizumi_sayuri@example.com	東京都
加瀬 さんま	kase_sanma@example.com	愛知県
長友 雅彦	nagatomo_masahiko@example.com	東京都
村瀬 瞬	murase_shun@example.com	三重県
染谷 一樹	someya_kazuki@example.com	東京都
森口 まみ	moriguchi_mami@example.com	佐賀県
南 しぼり	minami_shibori@example.com	京都府
志村 丈雄	shimura_takeo@example.com	千葉県
阿久津 長利	akutsu_nagatoshi@example.com	宮城県
今井 完爾	imai_kanji@example.com	神奈川県
田口 広司	taguchi_kouji@example.com	北海道
柴山 希	shibayama_nozomi@example.com	大阪府
小関 法嗣	kozeki_houshi@example.com	埼玉県
高崎 なぎさ	takasaki_nagisa@example.com	北海道
梅津 大樹	umedu_hiroki@example.com	鹿児島県
江原 太朗	ehara_tarou@example.com	東京都
久保田 真希	kubota_maki@example.com	千葉県
藤井 明宏	fujii_akihiro@example.com	岡山県
浜本 栄一	hamamoto_eiichi@example.com	三重県
浅野 沙耶	asano_saya@example.com	福井県
勝地 六郎	katsudi_rokurou@example.com	神奈川県
畠山 祐一	hatayama_yuuichi@example.com	長崎県
広田 亮	hirota_ryou@example.com	神奈川県
神木 晃司	kamiki_kouji@example.com	神奈川県
小峰 憲史	komine_norihito@example.com	東京都
田崎 裕司	tazaki_yuuji@example.com	愛知県
柳沢 メイサ	yanagisawa_meisa@example.com	埼玉県
牧田 由美子	makita_yumiko@example.com	栃木県
小高 敦	kodaka_atsushi@example.com	北海道
大田 翔	oota_shou@example.com	栃木県
大河内 憲史	ookouchi_norihito@example.com	宮城県
稲田 咲	inada_saki@example.com	東京都
石渡 剛基	ishiwatari_yoshiki@example.com	栃木県
植松 瑠璃亜	uematsu_ruria@example.com	岩手県
立石 まひる	tachiishi_mahiru@example.com	群馬県
彼方 憲一	kanata_kenichi@example.com	大阪府
真田 ジョージ	sanada_george@example.com	京都府
久保田 人志	kubota_hitoshi@example.com	兵庫県
浅倉 功補	asakura_kousuke@example.com	大阪府
大島 勇一	ooshima_yuuichi@example.com	茨城県
大井 由宇	ooi_yuu@example.com	熊本県
田崎 菜々美	tazaki_nanami@example.com	福岡県
小寺 竜也	kodera_tatsuya@example.com	福岡県
佐々木 薫	sasaki_kaoru@example.com	大分県
北川 人志	kitakawa_hitoshi@example.com	愛知県
志村 ひろ子	shimura_hiroko@example.com	東京都
野上 和香	nogami_waka@example.com	千葉県
小川 亮介	ogawa_ryousuke@example.com	山梨県
染谷 守	someya_mamoru@example.com	大阪府
小平 知世	kohira_chise@example.com	愛媛県
大地 茂樹	oochi_shigeki@example.com	埼玉県
楠 将也	kusunoki_masaya@example.com	北海道
多田 景子	tada_keiko@example.com	大阪府
長澤 丈雄	nagasawa_takeo@example.com	青森県
森脇 賢治	moriwaki_kenji@example.com	滋賀県
宮田 薫	miyata_kaoru@example.com	愛知県
高倉 南朋	takakura_nao@example.com	茨城県
西村 由宇	nishimura_yuu@example.com	愛知県
荒木 知史	araki_tomofumi@example.com	福岡県
玉井 育子	tamai_ikuko@example.com	神奈川県
藤原 敦	fujiwara_atsushi@example.com	埼玉県
長友 きみまろ	nagatomo_kimimaro@example.com	高知県
武内 まひる	takeuchi_mahiru@example.com	北海道
福士 ひろみ	fukushi_hiromi@example.com	東京都
大森 育子	oomori_ikuko@example.com	神奈川県
西村 景子	nishimura_keiko@example.com	千葉県
樋口 一代	higuchi_kazuyo@example.com	北海道
香川 隆	kagawa_takashi@example.com	宮城県
河西 竜也	kawanishi_tatsuya@example.com	宮城県
須賀 勇一	suga_yuuichi@example.com	東京都
小市 隼士	koichi_shunji@example.com	静岡県
大庭 あさみ	ooniwa_asami@example.com	東京都
海老原 寛治	ebihara_kanji@example.com	福島県
上田 昌代	ueda_masayo@example.com	千葉県
片山 敏和	katayama_toshikazu@example.com	神奈川県
松浦 サンタマリア	matsuura_stmaria@example.com	静岡県
長瀬 正敏	nagase_masatoshi@example.com	福岡県
坂上 かおり	sakagami_kaori@example.com	秋田県
井沢 小雁	izawa_kogan@example.com	長野県
井上 美紀	inoue_miki@example.com	福島県
南 竜次	minami_ryuuji@example.com	鹿児島県
永井 遥	nagai_haruka@example.com	静岡県
荻原 宏	hagiwara_hiroshi@example.com	埼玉県
田口 慎之介	taguchi_shinnosuke@example.com	福岡県
丸山 くるみ	maruyama_kurumi@example.com	埼玉県
木本 龍吉	kimoto_ryuukichi@example.com	神奈川県
松野 みゆき	matsuno_miyuki@example.com	宮崎県
熊沢 美佐子	kumasawa_misako@example.com	群馬県
山岸 充則	yamagishi_mitsunori@example.com	新潟県
神木 小百合	kamiki_sayuri@example.com	兵庫県
山岸 弘也	yamagishi_hironari@example.com	大分県
中山 弘也	nakayama_hironari@example.com	千葉県
桜田 フミヤ	sakurada_fumiya@example.com	秋田県
宮下 メイサ	miyashita_meisa@example.com	静岡県
長岡 ケンイチ	nagaoka_kenichi@example.com	埼玉県
妹尾 真奈美	seo_manami@example.com	福井県
土谷 康文	tsuchiya_yasufumi@example.com	新潟県
永井 ジローラモ	nagai_girolamo@example.com	石川県
土井 里奈	doi_rina@example.com	宮城県
広川 杏	hirokawa_ann@example.com	東京都
浅井 サンタマリア	asai_stmaria@example.com	新潟県
末永 恭子	suenaga_kyouko@example.com	長野県
伊藤 雅彦	itou_masahiko@example.com	東京都
橋口 明	hashiguchi_akira@example.com	兵庫県
大沢 隆之介	oosawa_ryuunosuke@example.com	大阪府
福田 瞳	fukuda_hitomi@example.com	兵庫県
川辺 あおい	kawabe_aoi@example.com	北海道
外山 晋也	sotoyama_shinya@example.com	京都府
高倉 公顕	takakura_kimiaki@example.com	東京都
筒井 太朗	tsutsui_tarou@example.com	京都府
土谷 あや子	tsuchiya_ayako@example.com	岡山県
飛田 貴嶺	hida_takane@example.com	鳥取県
河内 フミヤ	kawauchi_fumiya@example.com	京都府
西村 正義	nishimura_masayoshi@example.com	東京都
七瀬 まさみ	nanase_masami@example.com	栃木県
中村 薫	nakamura_kaoru@example.com	大阪府
水上 あや子	mizukami_ayako@example.com	神奈川県
山野 慶太	yamano_keita@example.com	愛知県
山岸 彩華	yamagishi_ayaka@example.com	佐賀県
松谷 たまき	matsutani_tamaki@example.com	静岡県
松川 賢治	matsukawa_kenji@example.com	滋賀県
長谷川 勝久	hasegawa_katsuhisa@example.com	北海道
原口 南朋	haraguchi_nao@example.com	東京都
中園 徹	nakazono_tooru@example.com	神奈川県
甲斐 晃司	kai_kouji@example.com	北海道
相武 菊生	aibu_kikuo@example.com	石川県
菊田 愛	kikuta_ai@example.com	北海道
小西 佑	konishi_tasuku@example.com	新潟県
長沢 哲平	nagasawa_teppei@example.com	愛知県
広末 倫子	hirosue_noriko@example.com	千葉県
浅利 みあ	asari_mia@example.com	福岡県
岩城 綾女	iwaki_ayame@example.com	東京都
西村 夏希	nishimura_natsuki@example.com	滋賀県
藤田 信輔	fujita_shinsuke@example.com	群馬県
戸田 路子	toda_michiko@example.com	愛知県
足立 圭	adachi_kei@example.com	兵庫県
手塚 景子	teduka_keiko@example.com	茨城県
稲垣 了	inagaki_ryou@example.com	栃木県
皆川 みあ	minakawa_mia@example.com	山梨県
瀬川 砂羽	segawa_sawa@example.com	大阪府
白木 俊二	shiraki_shunji@example.com	香川県
小沼 咲	konuma_saki@example.com	埼玉県
秋山 くるみ	akiyama_kurumi@example.com	滋賀県
田川 夏希	tagawa_natsuki@example.com	愛知県
甲斐 まなみ	kai_manami@example.com	栃木県
金田 瞬	kaneda_shun@example.com	岡山県
安永 愛子	yasunaga_aiko@example.com	広島県
大路 一	ooji_hajime@example.com	静岡県
伊集院 朝香	ijuuin_asaka@example.com	茨城県
西田 敏和	nishida_toshikazu@example.com	秋田県
野口 沙耶	noguchi_saya@example.com	滋賀県
岡野 由樹	okano_yuki@example.com	神奈川県
岩下 将也	iwashita_masaya@example.com	東京都
米谷 崇史	yoneya_takashi@example.com	京都府
岩瀬 和香	iwase_waka@example.com	福岡県
波多野 竜也	hatano_tatsuya@example.com	千葉県
ユースケ 樹里	yusuke_juri@example.com	千葉県
成瀬 博明	naruse_hiroaki@example.com	千葉県
竹本 桃子	takemoto_momoko@example.com	神奈川県
渋谷 えみ	shibuya_emi@example.com	愛知県
高瀬 希	takase_nozomi@example.com	大阪府
三木 麻由子	miki_mayuko@example.com	滋賀県
宮沢 大五郎	miyazawa_daigorou@example.com	長崎県
草野 メイサ	kusano_meisa@example.com	岐阜県
大地 かおり	oochi_kaori@example.com	山口県
堀江 恵美	horie_megumi@example.com	大阪府
梅津 真奈美	umedu_manami@example.com	山形県
江原 ひとみ	ehara_hitomi@example.com	秋田県
竹下 怜奈	takeshita_reina@example.com	福岡県
中井 勝久	nakai_katsuhisa@example.com	岐阜県
三井 花	mitsui_hana@example.com	熊本県
西沢 美和子	nishizawa_miwako@example.com	神奈川県
石垣 雅彦	ishigaki_masahiko@example.com	香川県
内村 直人	uchimura_naoto@example.com	沖縄県
古田 里穂	furuta_riho@example.com	愛知県
小幡 陽子	obata_youko@example.com	愛知県
黒田 愛	kurota_ai@example.com	東京都
大下 小雁	ooshita_kogan@example.com	山梨県
篠山 光洋	shinoyama_mitsuhiro@example.com	愛知県
永田 鉄二	nagata_tetsuji@example.com	京都府
浅沼 真悠子	asanuma_mayuko@example.com	東京都
藤井 さやか	fujii_sayaka@example.com	宮崎県
遠藤 惇	enndou_jun@example.com	長野県
古賀 光洋	koga_mitsuhiro@example.com	埼玉県
大森 一輝	oomori_kazuki@example.com	北海道
早美 美幸	hayami_miyuki@example.com	北海道
境 浩太郎	sakai_koutarou@example.com	茨城県
麻生 竜次	asou_ryuuji@example.com	福岡県
大路 敏和	ooji_toshikazu@example.com	京都府
長尾 璃子	nagao_riko@example.com	福岡県
小田島 慶太	odajima_keita@example.com	新潟県
下村 瞬	shimomura_shun@example.com	神奈川県
伊丹 大樹	itami_hiroki@example.com	富山県
池田 明慶	ikeda_akiyoshi@example.com	熊本県
浅倉 恵麻	asakura_ema@example.com	福島県
金井 昌代	kanai_masayo@example.com	山梨県
生田 龍吉	namata_ryuukichi@example.com	宮城県
角田 愛梨	kadota_airi@example.com	埼玉県
金井 美咲	kanai_misaki@example.com	山梨県
柴田 小百合	shibata_sayuri@example.com	東京都
山本 育二	yamamoto_ikuji@example.com	宮城県
島本 鉄洋	shimamoto_tetsuhiro@example.com	大阪府
富樫 綾女	togashi_ayame@example.com	神奈川県
鎌田 雄太	kamata_yuuta@example.com	埼玉県
亀山 陽子	kameyama_youko@example.com	兵庫県
坂上 美咲	sakagami_misaki@example.com	京都府
小市 涼	koichi_ryou@example.com	福岡県
芹沢 俊介	serizawa_shunsuke@example.com	三重県
阪本 直人	sakamoto_naoto@example.com	愛媛県
西川 まみ	nishikawa_mami@example.com	大阪府
藤井 さとみ	fujii_satomi@example.com	福島県
久米 美佐	kume_misa@example.com	大阪府
山田 徹	yamada_tohru@example.com	埼玉県
高田 菜々美	takada_nanami@example.com	岡山県
吹石 一哉	fukiishi_kazuya@example.com	群馬県
宮沢 夏空	miyazawa_sora@example.com	埼玉県
沢田 なつみ	sawada_natsumi@example.com	青森県
哀川 真帆	aikawa_maho@example.com	長崎県
木下 真悠子	kinoshita_mayuko@example.com	埼玉県
小幡 広之	obata_hiroyuki@example.com	東京都
増井 優	masui_yuu@example.com	大分県
藤井 洋	fujii_you@example.com	茨城県
田畑 樹里	tabata_juri@example.com	東京都
菅谷 早織	sugaya_saori@example.com	鹿児島県
児島 みあ	kojima_mia@example.com	大分県
片山 洋介	katayama_yousuke@example.com	福岡県
杉原 洋	sugihara_you@example.com	千葉県
津田 耕司	tsuda_kouji@example.com	愛知県
村岡 六郎	muraoka_rokurou@example.com	山形県
川田 あおい	kawata_aoi@example.com	宮崎県
黒川 恵梨香	kurokawa_erika@example.com	福岡県
志賀 千佳子	shiga_chikako@example.com	山梨県
羽田 遥	hada_haruka@example.com	佐賀県
葛山 あい	katsurayama_ai@example.com	群馬県
重田 弘也	shigeta_hironari@example.com	神奈川県
根本 未來	nemoto_mirai@example.com	岐阜県
佐久間 崇史	sakuma_takashi@example.com	東京都
秦 恵麻	hata_ema@example.com	新潟県
深田 さとみ	fukada_satomi@example.com	岐阜県
木本 大樹	kimoto_hiroki@example.com	神奈川県
蛍原 詩織	hotohara_shiori@example.com	徳島県
滝 誠治	taki_seiji@example.com	福島県
山村 勇太	yamamura_yuuta@example.com	北海道
上条 奈々	kamijou_nana@example.com	奈良県
河野 明	kawano_akira@example.com	兵庫県
黒崎 杏	kurosaki_ann@example.com	三重県
石本 裕次郎	ishimoto_yuujirou@example.com	鳥取県
岸本 涼子	kishimoto_ryouko@example.com	三重県
ト字 洋	toji_you@example.com	愛知県
下川 璃子	shimokawa_riko@example.com	東京都
筧 真希	kakei_maki@example.com	京都府
甲斐 礼子	kai_reiko@example.com	愛知県
菊田 光博	kikuta_mitsuhiro@example.com	鳥取県
高瀬 三省	takase_sansei@example.com	岡山県
比嘉 美優	hiyoshi_myuu@example.com	東京都
芳賀 淳子	haga_atsuko@example.com	愛知県
柳家 信吾	yanagiya_shingo@example.com	沖縄県
吹石 たまき	fukiishi_tamaki@example.com	東京都
工藤 美菜	kudou_mina@example.com	福岡県
宇野 莉央	uno_rio@example.com	大阪府
豊田 晋也	toyota_shinya@example.com	岐阜県
平 雅彦	taira_masahiko@example.com	群馬県
大河内 博明	ookouchi_hiroaki@example.com	高知県
佐藤 恵子	satou_keiko@example.com	兵庫県
松居 南朋	matsui_nao@example.com	沖縄県
今田 あおい	imada_aoi@example.com	宮崎県
金子 陽子	kaneko_youko@example.com	青森県
大野 きみまろ	oono_kimimaro@example.com	鹿児島県
中岡 遥	nakaoka_haruka@example.com	新潟県
宇多田 浩正	utada_hiromasa@example.com	北海道
稲田 由宇	inada_yuu@example.com	兵庫県
田畑 光洋	tabata_mitsuhiro@example.com	広島県
村中 なつみ	muranaka_natsumi@example.com	埼玉県
大内 礼子	oouchi_reiko@example.com	岩手県
大村 紗季	oomura_saki@example.com	東京都
加藤 美佳	katou_mika@example.com	福島県
山下 一徳	yamashita_ittoku@example.com	島根県
寺本 隼士	teramoto_shunji@example.com	鹿児島県
宮地 景子	miyaji_keiko@example.com	福岡県
森永 晴臣	morinaga_haruomi@example.com	神奈川県
神田 亮介	kannda_ryousuke@example.com	愛知県
坪井 達士	tsuboi_tatsuhito@example.com	静岡県
小山 さやか	oyama_sayaka@example.com	富山県
亀山 美幸	kameyama_miyuki@example.com	千葉県
関 あや子	seki_ayako@example.com	宮城県
山中 真奈美	yamanaka_manami@example.com	東京都
杉田 くるみ	sugita_kurumi@example.com	千葉県
堤 達士	tsutsumi_tatsuhito@example.com	大阪府
高山 季衣	takayama_toshie@example.com	東京都
板垣 将也	itagaki_masaya@example.com	栃木県
堀北 雅彦	horikita_masahiko@example.com	茨城県
